11111111111111111111111111111111111111
1P000000000000000000000000000000001
10101010101010101010101010101010101
10000000000000000000000000000000001
10101010101010101010101010101010101
10000000000000000000000000000000001
10101010101010101010101010101010101
10000000000000000000000000000000001
10101010101010101010101010101010101
100000000000000C0000000000000000001
10101010101010101010101010101010101
10000000000000000000000000000000001
10101010101010101010101010101010101
100000000000000C0000000000000000001
10101010101010101010101010101010101
10000000000000000000000000000000001
10101010101010101010101010101010101
100000000000000C0000000000000000001
10101010101010101010101010101010101
10000000000000000000000000000000E01
11111111111111111111111111111111111
